[console_scripts]
nova-api = nova.cmd.api:main
nova-api-metadata = nova.cmd.api_metadata:main
nova-api-os-compute = nova.cmd.api_os_compute:main
nova-compute = nova.cmd.compute:main
nova-conductor = nova.cmd.conductor:main
nova-manage = nova.cmd.manage:main
nova-novncproxy = nova.cmd.novncproxy:main
nova-policy = nova.cmd.policy:main
nova-rootwrap = oslo_rootwrap.cmd:main
nova-rootwrap-daemon = oslo_rootwrap.cmd:daemon
nova-scheduler = nova.cmd.scheduler:main
nova-serialproxy = nova.cmd.serialproxy:main
nova-spicehtml5proxy = nova.cmd.spicehtml5proxy:main
nova-status = nova.cmd.status:main

[nova.api.extra_spec_validators]
accel = nova.api.validation.extra_specs.accel
aggregate_instance_extra_specs = nova.api.validation.extra_specs.aggregate_instance_extra_specs
capabilities = nova.api.validation.extra_specs.capabilities
hw = nova.api.validation.extra_specs.hw
hw_rng = nova.api.validation.extra_specs.hw_rng
hw_video = nova.api.validation.extra_specs.hw_video
null = nova.api.validation.extra_specs.null
os = nova.api.validation.extra_specs.os
pci_passthrough = nova.api.validation.extra_specs.pci_passthrough
powervm = nova.api.validation.extra_specs.powervm
quota = nova.api.validation.extra_specs.quota
resources = nova.api.validation.extra_specs.resources
traits = nova.api.validation.extra_specs.traits
vmware = nova.api.validation.extra_specs.vmware

[nova.compute.monitors.cpu]
virt_driver = nova.compute.monitors.cpu.virt_driver:Monitor

[nova.scheduler.driver]
filter_scheduler = nova.scheduler.filter_scheduler:FilterScheduler

[oslo.config.opts]
nova.conf = nova.conf.opts:list_opts

[oslo.config.opts.defaults]
nova.conf = nova.middleware:set_defaults

[oslo.policy.enforcer]
nova = nova.policy:get_enforcer

[oslo.policy.policies]
nova = nova.policies:list_rules

[wsgi_scripts]
nova-api-wsgi = nova.api.openstack.compute.wsgi:init_application
nova-metadata-wsgi = nova.api.metadata.wsgi:init_application

